1 1
#######
#     #
#   $@#
# .   #
# . $ #
#     #
#######
