23 44 83
##########
#        #
# $ # $  #
#   .# . #
#        #
#   @    #
# $  .   #
#        #
#        #
##########
