27 92 43
#####
#.@ #
#$$##
#   #
# $ #
#  ##
# ###
#.###
#.###
#####