4 10 10
    #####          
    #   #          
    #   #          
  ###   ##         
  #  $   #         
### # ## #   ######
#   # ## #####   .#
# $  $           .#
##### ### #@##   .#
    #     #########
    #######        