51 7 10 17 78
 ######     
 #    ###   
 #$# $  ####
##   .   $ #
# $  #     #
#   .## ####
## # ##.  # 
 # # ##@  # 
 #.# ## $## 
 ###.##  #  
   #######  